1,10;4,4;10,1;10,4;6,1;8,10;
XXXXXXXXXXXX
XOOXOOOOOOOX
XOOOOOOOXOXX
XOOOXOXOOOOX
XXOXOXOXXOOX
XOOOOOOOOOOX
XOOOOOOOOOOX
XXXOOOOOXXXX
XOOOOOOXXOOX
XOOXOOOOOOOX
XOOOOXXOOOXX
XXXXXXXXXXXX