1,7;3,6;6,10;10,7;8,1;5,5
XXXXXXXXXXXX
XOXOXOXOXOXX
XOXOOOXOOOXX
XOOOOOOOOOOX
XXOXOXOXOXOX
XOOXOOOXOOOX
XOOOOOOOOOOX
XOXOXOXOXOXX
XOXOOOXOOOXX
XOOXOOOXXOOX
XOOOOOOOOOOX
XXXXXXXXXXXX


