1,4;2,9;7,10;9,1;9,10;5,5;
XXXXXXXXXXXX
XOOXOXOOOXXX
XOOXOOOOOOXX
XOOOOOOOOXOX
XXXXOXOOOOOX
XXOOXOXOOOOX
XOOOOOOOXXXX
XOOOOOOOOOOX
XXXOOOOOOOOX
XOOXXOOOOXOX
XOOOOOOOOOXX
XXXXXXXXXXXX

 
  