1,10;4,1;5,8;8,3;7,10;6,6;
XXXXXXXXXXXX
XOXXXXOOOOOX
XOOOOOOOOOOX
XXXXXXOOXXXX
XOOOOOOOOOOX
XXXXOXXXOXXX
XOOOOOOOOOOX
XXOXOXOXOXOX
XXXOOOOOOXXX
XOXXOOOOXXOX
XOOOOOOOOOOX
XXXXXXXXXXXX