3,4;6,5;5,9;5,3;9,3;8,10;
XXXXXXXXXXXX
XOOOOOXXXXXX
XXXXXOOOOXXX
XXXXOOOOXXXX
XXXOOOOOOXXX
XXOOXXXOOOXX
XXXOOOOOXXXX
XOOOXXOOOXXX
XOOOOOOXOOOX
XXOOOOOXOOOX
XXXOOOOOOOXX
XXXXXXXXXXXX