9,2;2,9;8,8;6,1;3,8;1,5;
XXXXXXXXXXXX
XOOOOOOOOOOX
XOXOOXOOXOXX
XOOXOOXOOXOX
XXOOOOXOOOOX
XXOOOXXOOOOX
XOXOXOOOOOOX
XOXOOOOXXOOX
XOOOXOOOOOOX
XOOXOOOOOXOX
XXXXOOOOOOXX
XXXXXXXXXXXX

