2,9;9,9;1,5;8,1;5,6;7,4;
XXXXXXXXXXXX
XOOXOOXOOXXX
XOOOOOXOOOXX
XXXXOOXOOOOX
XOOOOOXOOOOX
XOOOOOOOOOOX
XOOOOOOOOOOX
XXXOOOXOOXXX
XOOOOOXOOOOX
XXOOOXXOOOXX
XXXOOOXOOXXX
XXXXXXXXXXXX

