1,7;5,8;10,6;9,9;7,4;10,1
XXXXXXXXXXXX
XOOOOXXOOOOX
XOOOOOOOOOOX
XOOOOXXOOOOX
XOOOOXXOOOOX
XXXOXXXOOXXX
XXOOXXXOXXXX
XOOOOXXOOOOX
XOOOOXXOOOOX
XOOOOXXOOOOX
XOOOOOOOOOOX
XXXXXXXXXXXX



