3,3;8,8;3,10;10,4;7,4;1,6;
XXXXXXXXXXXX
XOOOOOOOOOOX
XOXXXOOXXXOX
XOXOOOOOOXOX
XOXOOOOOOXOX
XOOOOXXOOOOX
XOOOOXXOOOOX
XOXOOOOOOXOX
XOXOOOOOOXOX
XOXXXOOXXXOX
XOOOOOOOOOOX
XXXXXXXXXXXX



