3,5;10,10;10,2;6,4;8,6;5,9;
XXXXXXXXXXXX
XOOXXXXXXXXX
XOOOOOXXXXXX
XXXXOOXXXXXX
XXXXXOOOOXXX
XXXXXXOOOOXX
XXXXOOOXXXXX
XXOOOOXXXXXX
XXXOOOOXXXXX
XXXXOOXOOOXX
XOOOOOOOXOOX
XXXXXXXXXXXX



